OOOOOOOOOOOOOOOOOOOOOOOOOOOOOOOOOOOOOOOOOOOOOOOOOOOOOOOOOOOOOOOOOOOOOOOOOOOOOOOOOOOOOOOOOOOOOOOOOOOOO
O   O   O O O   O   O       O O   O O O     O   O   O O   O             O   O O O   O O             O
OOO OOO O O O OOOOO OOO OOOOO O O O O O OOOOO OOO OOO O OOO O OOO OOOOOOO OOO O OOO O OOO OOOOOOOOO O
O O O O   O   O   O O   O O O   O     O   O   O O   O       O O O   O O   O         O O O     O   O O
O O O OOO OOO OOO O OOO O O OOOOOOOOO O OOO OOO O OOO OOO OOOOO OOOOO O OOOOOOO OOOOO O O O OOO O OOO
O     O O O O O     O   O     O               O   O     O     O   O O   O O O   O O O O   O   O O   O
OOO O O O O O OOO OOO OOO OOOOOOOOOOO OOOOOOOOO OOO OOO OOOOOOO OOO O OOO O OOO O O O O OOOOOOO OOOOO
O   O   O     O O O     O   O       O   O   O O       O   O     O       O   O O   O O   O O O O O O O
OOOOO OOOOOOO O O OOO OOOOO O OOOOO O OOO OOO O OOOOOOOOOOOOO OOO O OOOOOOO O O OOO O OOO O O O O O O
O       O O   O O         O O O O O O     O   O   O O     O     O O O     O   O                     O
OOO O O O O OOO OOOOO OOOOO OOO O O O OOO O OOO OOO OOO OOOOO OOO OOOOO OOO OOO OOOOOOOOOOOOOOOOOOOOO
O   O O     O   O O O     O O       O   O O       O                         O     O   O O   O   O   O
O O O O OOO OOO O O OOO OOO OOOOO OOO OOOOOOO OOOOO O OOOOO OOOOO O O OOOOOOOOO OOO OOO O OOO OOO OOO
O O O O O           O           O O                 O O   O     O O O           O O O O       O O   O
OOOOOOOOOOOOOOO O O OOOOOOOOO O O OOO O OOO OOO O OOOOO OOOOOOO OOOOOOOOOOO OOOOO O O OOO OOO O O OOO
O     O   O     O O   O O   O O   O   O   O O O O   O         O O O   O   O   O             O       O
OOOOO OOO OOOOO OOOOO O O OOOOOOO O OOOOOOOOO OOO OOO OOOOOOOOOOO OOO O O OOOOO OOO O OOO OOOOOOO O O
O         O     O       O   O   O   O           O   O                   O         O O O         O O O
OOOOOOOOO OOOOOOOOOOOOO O OOOOO OOO O OOO OOOOO OOOOO O OOOOOOOOO O OOOOOOO OOOOOOO OOOOOOO OOO OOO O
O O   O     O     O O O   O   O         O     O O O   O O   O O O O O     O   O O     O O     O O   O
O OOO OOO OOOOOOO O O O OOO OOO OOOOOOOOOOOOOOOOO O OOO OOO O O OOO O OOOOOOOOO OOOOOOO OOOOOOOOOOOOO
O   O   O   O   O O     O   O O     O O O O O     O O O   O       O O   O O   O   O O         O     O
O O OOO O OOOOO O OOOOO OOO O O OOOOO O O O O OOOOO O OOOOOOO OOOOOOO OOO OOO O OOO O OOOOOOOOOOOOO O
O O   O       O O O   O O O       O   O O O   O O               O O   O O O O O       O   O     O O O
O OOO O OOOOO O O O OOO O OOOOO O O OOO O O OOO O OOOOOOOOOOO OOO O OOO O O O O O OOOOO OOO OOOOO O O
O O     O     O O O O     O   O O       O   O         O     O   O   O   O O O   O O       O     O O O
O OOO OOO OOO O O O O OOO OOO O OOO OOO O OOOOO OOO O O OOOOO OOOOO O OOO O O O OOO OOOOOOO OOOOO O O
O O   O   O       O   O     O   O O   O   O       O O   O O O   O       O O O O   O O O   O O O O   O
OOOOOOOOOOO OOOOO O OOO O O OOO O OOOOOOOOOOOOO OOOOOOOOO O OOOOO OOOOOOO O O OOOOO O O OOO O O O OOO
O O     O   O       O   O O   O   O       O           O       O O O       O         O O           O O
O OOO O OOO O OOOOOOO OOOOOOO O OOO OOO OOO O O OOO OOO OOOOOOO O O O OOO O OOOOOOOOO O OOOOO OOOOO O
O     O   O O O       O     O O O     O O   O O   O   O     O O     O   O O   O O   O       O       O
O OOO O O OOOOOOOOOOO OOOOO O O O OOOOOOO OOOOOOOOOOO O OOOOO OOO OOOOOOOOO OOO O OOO OOO OOOOO OOOOO
O   O O O   O         O       O O   O     O     O   O     O     O   O     O O   O O O O O   O O O O O
OOOOO O O OOOOOOOOO OOO O OOO O O OOO O O O OOO O OOOOOOOOOOO OOO OOO OOOOO O OOO O O O OOOOO O O O O
O     O O   O       O   O   O         O O     O O       O   O O O O O O               O O     O O O O
OOOOOOOOOOO OOOOO OOOOOOO OOO O OOOOOOOOOOOOO OOO OOOOOOO OOO O O O O O O O OOOOOOO O O OOO OOOOO O O
O O     O O     O     O O O   O     O   O   O O               O O O     O O       O O     O   O     O
O OOOOO O OOOOO O O OOO O O OOO OOOOO OOOOO OOO O OOO OOO OOO O O O OOOOOOOOO OOO O O O O O OOO O O O
O O   O   O O O   O   O   O O               O   O   O   O   O               O   O O O O O       O O O
O OOO OOO O O O O O OOO O O O O OOO OOOOO O O OOOOOOO O OOO OOOOO OOOOOOOOOOOOOOO OOO O O OOOOO OOO O
O               O O O   O O O O   O     O O   O O   O O   O     O   O           O O   O O   O   O O O
OOO OOO OOOOOOOOO OOO O OOO O OOOOO O OOOOOOOOO O OOOOOOO OOO O OOOOO OOOOO OOOOOOO OOO O OOO O O OOO
O   O   O         O   O O O O O     O O O   O   O       O O O O           O O   O     O O O   O O   O
O O OOOOO OOO OOOOO OOO O OOOOO O O OOO O O OOO O OOOOOOOOO OOO OOOOO OOOOOOO OOOOOOOOOOOOOOO O O OOO
O O O     O     O   O   O O     O O       O                   O     O   O O       O O O   O   O     O
OOO OOO OOO O O OOOOO O O O O OOOOO OOOOOOOOOOOOO OOOOO OOOOOOOOOOOOO OOO O OOOOOOO O O OOO O O OOO O
O   O O O   O O O O   O O   O O   O       O     O     O O O         O   O                 O O O   O O
O OOO OOO OOOOOOO OOOOOOO OOO O O OOO O OOO O OOO O OOOOO O OOO O O O OOO OOO OOOOO O OOO O OOO OOOOO
O O     O O O               O O O     O     O O O O           O O O O O O   O     O O O O O O     O O
OOOOOOO OOO O OOO OOO O O OOO OOO O OOOOO O OOO OOOOOOOOOOOOOOO OOO OOO O OOO O O OOO O O O OOO O O O
O   O     O O O     O O O O   O   O O   O O O       O   O     O   O         O O O O O   O O O   O   O
OOO O OOO O OOOOO O OOOOO OOOOOOO O O OOO OOO OOOOOOO OOO OOOOOOOOOOOOO OOO OOOOOOO OOO O OOO O O OOO
O     O O     O   O O O   O       O O   O                     O   O   O   O   O       O O O   O O   O
OOOOOOO OOOOO O OOO O O OOO OOO O O O OOOOOOOOO O OOO OOOOOOOOO OOO O OOOOO OOOOO OOO O O OOOOOOO OOO
O O O           O O O     O   O O O       O   O O O O           O   O     O         O O O   O O     O
O O OOOOO OOOOO O OOOOOOO OOO OOO OOOOO OOO OOO OOO OOOOOOOOOOOOO OOOOOOO O OOOOO OOOOOOOOOOO O O OOO
O         O     O         O   O O   O         O         O   O O O   O O O O   O   O   O     O   O O O
OOOOO O OOOOOOO O O O OOOOOOO O O OOOOO O OOOOO O O OOOOO OOO O O O O O OOOOO OOOOO OOO OOOOOOOOOOO O
O     O O       O O O O         O   O   O     O O O     O   O O   O         O O   O O   O O O O   O O
O OOO OOOOOOOOOOOOO OOOOOOO O O O OOOOO OOOOOOOOO O O OOO OOO O O OOOOO OOO OOOOO O O OOO O O OOO O O
O   O O     O           O   O O O   O           O O O           O     O O O       O   O   O O     O O
O OOOOOOOOO O OOO OOO OOOOO OOO O OOO O O O OOO O O OOOOOOOOO OOO O O OOO OOOOOOOOO OOO OOO OOO OOO O
O O           O   O       O O   O O   O O O O O O O     O     O   O O   O         O       O       O O
OOOOOOOOOOO O O O O O O OOOOO O O O O OOO O O OOO O O O OOO O O O O O O O O OOOOOOO O OOO O OOOOOOO O
O O         O O O O O O O     O O O O O   O O O   O O O   O O O O O O O   O   O O O O O             O
O OOOOO OOOOOOOOOOO O OOOOO O O OOO OOOOO OOO OOOOOOOOO O O OOOOOOO O OOOOO O O O O OOO OOO OOOOOOO O
O     O   O         O     O O O   O O O               O O O     O   O   O   O       O O O O       O O
O OOO O OOOOOOOOOOO O OOOOO OOO OOO O O OOO O O OOOOO OOOOO O OOO OOO O OOO O O OOO O OOO OOO OOO O O
O O     O O         O   O     O O     O   O O O   O       O O O     O O   O O O   O         O   O O O
O OOO O O OOOOOOOOO OOO OOO OOO O O OOO OOOOO O O O O O OOOOO O O O O OOO O OOOOOOO OOO OOOOOOO OOO O
O O   O O             O O     O O O   O     O O O O O O   O   O O O O   O O   O O   O O O O   O O   O
OOO OOO O OOOOO OOO OOOOO O OOOOOOO OOOOO OOOOOOO O OOO O OOOOO O OOOOOOOOO OOO OOO O O O O OOOOOOO O
O   O O O O O     O O O   O     O   O O       O   O O   O     O O       O         O   O O     O   O O
OOOOO O OOO O O OOOOO OOOOO OOOOOOO O OOO OOO OOO OOO OOOOO OOOOO OOO O O OOOOO OOOOO O O OOOOO OOOOO
O   O O O O   O   O O             O     O O O   O   O   O     O     O O O O       O   O             O
OOO O OOO O OOOOOOO O OOO OOO O OOOOO OOO O O OOOOOOO O OOOOO OOO O OOOOOOO O OOOOO O O OOOOOOO OOO O
O           O O O     O   O   O     O   O   O     O O O     O O O O O       O   O   O O       O O   O
O OOO OOOOOOO O O O OOOOO O O OOOOO OOOOOOO O O O O O O OOO O O OOOOOOO OOOOO O OOOOO O O OOOOO OOOOO
O O   O           O O     O O   O       O O O O O   O O   O O     O       O   O O     O O     O   O O
OOO OOO O O OOO O OOOOOOOOOOO OOO O O OOO OOOOO OOOOOOO OOOOOOO O O OOO O O O OOO O O OOOOOOO OOO O O
O   O   O O   O O O O           O O O         O     O         O O O O O O O O O   O O   O   O   O   O
O OOO OOOOO O O OOO OOOOOOOOOOO O OOO OOO O OOO OOOOO O O O OOO O OOO O O OOOOO OOOOO OOO OOOOOOOOOOO
O   O O     O O   O             O O     O O   O   O O O O O   O O     O O     O     O               O
OOO O O OOOOO OOOOO OOOOO O O OOO O O O OOO O OOOOO OOOOOOOOOOOOO OOO OOOOOOO OOO OOO O O OOO O O OOO
O   O O   O     O     O   O O O O O O O O   O                   O   O   O   O O     O O O   O O O   O
OOO OOO O O O OOOOO OOOOOOO O O O OOOOO OOO OOO O O OOOOO O O O O OOOOO O O O OOOOOOO O O OOOOOOOOOOO
O O O   O O O O     O       O O       O O     O O O     O O O O O     O   O O O       O O     O O O O
O O O OOOOO O O OOO O O OOO OOO OOO OOO OOO OOOOO OOOOOOOOO OOO O O O O OOOOOOO O O O OOOOOOO O O O O
O   O O     O O O   O O O     O O   O     O     O         O   O O O O O       O O O O       O       O
OOO OOOOO O O OOO OOOOO O O O OOOOOOOOO OOOOO O OOO OOOOO O OOO OOO O O OOOOOOOOO OOOOO O O O O O OOO
O O O     O O   O   O   O O O         O O O   O   O     O O   O O   O O     O     O     O O O O O   O
O O O O O OOOOOOOOOOO O O OOO O OOOOOOO O O O OOOOOOO O OOOOO OOOOOOO O O O OOO O O OOO O O OOO OOOOO
O   O O O O           O O   O O O         O O       O O   O O       O O O O   O O O O   O O O O     O
OOO OOOOOOO OOO O O OOO O OOO OOOOOOO O O OOO OOOOOOOOOOOOO OOOOO OOO OOO O OOOOO OOO O OOOOO OOOOOOO
O     O     O   O O O   O O     O     O O O     O     O     O   O   O O   O O       O O           O O
OOO OOOOOOOOOOOOO O OOO OOO O O OOO OOOOO OOOOOOO OOOOO OOOOO OOOOOOO OOO O OOO OOO OOOOO O OOOOO O O
O     O O O   O O O O   O   O O O   O                               O O   O O     O     O O   O     O
O O OOO O OOO O OOOOO O O OOO OOOOOOOOOOO OOO O O OOO O OOO O O OOOOOOOOOOOOO O O O O OOO O OOO O OOO
O O   O               O O O       O       O   O O   O O O   O O           O   O O O O   O O   O O   O
OOOOOOOOOOOOOOOOOOOOOOOOOOOOOOOOOOOOOOOOOOOOOOOOOOOOOOOOOOOOOOOOOOOOOOOOOOOOOOOOOOOOOOOOOOOOOOOOOOOGO
