OOOOOOOOOOOOOOO
O   O         O
O OOO OOO OOOOO
O       O     O
O O OOOOOOOOOOO
O O     O   O O
OOO OOO O OOO O
O     O   O O O
OOO OOOOOOO O O
O             O
OOO O OOOOOOOOO
O   O         O
O O O OOOOO O O
O O O     O O O
OOOOOOOOOOOOOOO
